Class: AtomikosProperties	at: org.springframework.boot.jta.atomikos
Class: AtomikosDependsOnBeanFactoryPostProcessor	at: org.springframework.boot.jta.atomikos
Class: AtomikosXAConnectionFactoryWrapper	at: org.springframework.boot.jta.atomikos
Class: AtomikosXADataSourceWrapper	at: org.springframework.boot.jta.atomikos
Class: WebServiceTemplateBuilder	at: org.springframework.boot.webservices.client
Class: BufferingApplicationStartup	at: org.springframework.boot.context.metrics.buffering
Class: DelegatingApplicationListener	at: org.springframework.boot.context.config
Class: AnsiOutputApplicationListener	at: org.springframework.boot.context.config
Class: DelegatingApplicationContextInitializer	at: org.springframework.boot.context.config
Class: ConfigTreeConfigDataLocationResolver	at: org.springframework.boot.context.config
Class: ConfigDataEnvironmentPostProcessor	at: org.springframework.boot.context.config
Class: ConfigDataNotFoundFailureAnalyzer	at: org.springframework.boot.context.config
Class: StandardConfigDataLoader	at: org.springframework.boot.context.config
Class: ConfigTreeConfigDataLoader	at: org.springframework.boot.context.config
Class: UserConfigurations	at: org.springframework.boot.context.annotation
Class: ApplicationPidFileWriter	at: org.springframework.boot.context
Class: ConfigurationPropertiesScanRegistrar	at: org.springframework.boot.context.properties
Class: SystemEnvironmentPropertyMapper	at: org.springframework.boot.context.properties.source
Class: LastMapping	at: org.springframework.boot.context.properties.source
Class: DefaultPropertyMapper	at: org.springframework.boot.context.properties.source
Class: SoftReferenceConfigurationPropertyCache	at: org.springframework.boot.context.properties.source
Class: IncompatibleConfigurationFailureAnalyzer	at: org.springframework.boot.context.properties
Class: ConfigurationPropertiesBindConstructorProvider	at: org.springframework.boot.context.properties
Class: EnableConfigurationPropertiesRegistrar	at: org.springframework.boot.context.properties
Class: BeanSupplier	at: org.springframework.boot.context.properties.bind
Class: IndexedElementsBinder	at: org.springframework.boot.context.properties.bind
Class: AggregateSupplier	at: org.springframework.boot.context.properties.bind
Class: AggregateBinder	at: org.springframework.boot.context.properties.bind
Class: NotConstructorBoundInjectionFailureAnalyzer	at: org.springframework.boot.context.properties
Class: CachingSupplier	at: org.springframework.boot.context.properties
Class: NullPointerExceptionSafeSupplier	at: org.springframework.boot.context.properties
Class: FileEncodingApplicationListener	at: org.springframework.boot.context
Class: ConfigurationWarningsApplicationContextInitializer	at: org.springframework.boot.context
Class: EventPublishingRunListener	at: org.springframework.boot.context.event
Class: ClasspathLoggingApplicationListener	at: org.springframework.boot.context.logging
Class: ContextIdApplicationContextInitializer	at: org.springframework.boot.context
Class: Instantiator	at: org.springframework.boot.util
Class: LambdaSafeCallback	at: org.springframework.boot.util
Class: Callback	at: org.springframework.boot.util
Class: Callbacks	at: org.springframework.boot.util
Class: GenericTypeFilter	at: org.springframework.boot.util
Class: ApplicationContextRequestMatcher	at: org.springframework.boot.security.servlet
Class: ApplicationContextServerWebExchangeMatcher	at: org.springframework.boot.security.reactive
Class: AbstractFilterRegistrationBean	at: org.springframework.boot.web.servlet
Class: AnnotationConfigServletWebApplicationContext	at: org.springframework.boot.web.servlet.context
Class: XmlServletWebServerApplicationContext	at: org.springframework.boot.web.servlet.context
Class: ServletComponentScanRegistrar	at: org.springframework.boot.web.servlet
Class: MultipartConfigFactory	at: org.springframework.boot.web.servlet
Class: SpringBootServletInitializer	at: org.springframework.boot.web.servlet.support
Class: MustacheViewResolver	at: org.springframework.boot.web.servlet.view
Class: DynamicRegistrationBean	at: org.springframework.boot.web.servlet
Class: OrderedRequestContextFilter	at: org.springframework.boot.web.servlet.filter
Class: OrderedHiddenHttpMethodFilter	at: org.springframework.boot.web.servlet.filter
Class: ApplicationContextHeaderFilter	at: org.springframework.boot.web.servlet.filter
Class: OrderedCharacterEncodingFilter	at: org.springframework.boot.web.servlet.filter
Class: OrderedFormContentFilter	at: org.springframework.boot.web.servlet.filter
Class: DefaultErrorAttributes	at: org.springframework.boot.web.servlet.error
Class: ServerPortInfoApplicationContextInitializer	at: org.springframework.boot.web.context
Class: WebServerPortFileWriter	at: org.springframework.boot.web.context
Class: MustacheViewResolver	at: org.springframework.boot.web.reactive.result.view
Class: AnnotationConfigReactiveWebApplicationContext	at: org.springframework.boot.web.reactive.context
Class: OrderedHiddenHttpMethodFilter	at: org.springframework.boot.web.reactive.filter
Class: DefaultErrorAttributes	at: org.springframework.boot.web.reactive.error
Class: WebServerFactoryCustomizerBeanPostProcessor	at: org.springframework.boot.web.server
Class: ErrorPageRegistrarBeanPostProcessor	at: org.springframework.boot.web.server
Class: RestTemplateBuilder	at: org.springframework.boot.web.client
Class: TomcatReactiveWebServerFactory	at: org.springframework.boot.web.embedded.tomcat
Class: TldPatterns	at: org.springframework.boot.web.embedded.tomcat
Class: TomcatServletWebServerFactory	at: org.springframework.boot.web.embedded.tomcat
Class: JettyServletWebServerFactory	at: org.springframework.boot.web.embedded.jetty
Class: JettyReactiveWebServerFactory	at: org.springframework.boot.web.embedded.jetty
Class: NettyReactiveWebServerFactory	at: org.springframework.boot.web.embedded.netty
Class: UndertowReactiveWebServerFactory	at: org.springframework.boot.web.embedded.undertow
Class: UndertowServletWebServerFactory	at: org.springframework.boot.web.embedded.undertow
Class: EnumMapping	at: org.springframework.boot.ansi
Class: SpringApplicationAdminMXBeanRegistrar	at: org.springframework.boot.admin
Class: AbstractDataSourceInitializer	at: org.springframework.boot.jdbc
Class: OracleDataSourceSettings	at: org.springframework.boot.jdbc
Class: DataSourceBuilder	at: org.springframework.boot.jdbc
Class: DataSourceUnwrapper	at: org.springframework.boot.jdbc
Class: TomcatDataSourcePoolMetadata	at: org.springframework.boot.jdbc.metadata
Class: AbstractDataSourcePoolMetadata	at: org.springframework.boot.jdbc.metadata
Class: HikariDataSourcePoolMetadata	at: org.springframework.boot.jdbc.metadata
Class: CompositeDataSourcePoolMetadataProvider	at: org.springframework.boot.jdbc.metadata
Class: CommonsDbcp2DataSourcePoolMetadata	at: org.springframework.boot.jdbc.metadata
Class: OracleUcpDataSourcePoolMetadata	at: org.springframework.boot.jdbc.metadata
Class: SystemEnvironmentPropertySourceEnvironmentPostProcessor	at: org.springframework.boot.env
Class: RandomValuePropertySourceEnvironmentPostProcessor	at: org.springframework.boot.env
Class: SpringApplicationJsonEnvironmentPostProcessor	at: org.springframework.boot.env
Class: EnvironmentPostProcessorApplicationListener	at: org.springframework.boot.env
Class: YamlPropertySourceLoader	at: org.springframework.boot.env
Class: PropertiesPropertySourceLoader	at: org.springframework.boot.env
Class: BuildProperties	at: org.springframework.boot.info
Class: GitProperties	at: org.springframework.boot.info
Class: RSocketPortInfoApplicationContextInitializer	at: org.springframework.boot.rsocket.context
Class: RSocketServerBootstrap	at: org.springframework.boot.rsocket.context
Class: RSocketServerException	at: org.springframework.boot.rsocket.server
Class: NettyRSocketServerFactory	at: org.springframework.boot.rsocket.netty
Class: ConcurrentReferenceCachingMetadataReaderFactory	at: org.springframework.boot.type.classreading
Class: CloudFoundryVcapEnvironmentPostProcessor	at: org.springframework.boot.cloud
Class: TaskSchedulerBuilder	at: org.springframework.boot.task
Class: TaskExecutorBuilder	at: org.springframework.boot.task
Class: AbstractFailureAnalyzer	at: org.springframework.boot.diagnostics
Class: FailureAnalyzers	at: org.springframework.boot.diagnostics
Class: LoggingFailureAnalysisReporter	at: org.springframework.boot.diagnostics
Class: NoUniqueBeanDefinitionFailureAnalyzer	at: org.springframework.boot.diagnostics.analyzer
Class: ValidationExceptionFailureAnalyzer	at: org.springframework.boot.diagnostics.analyzer
Class: UnboundConfigurationPropertyFailureAnalyzer	at: org.springframework.boot.diagnostics.analyzer
Class: BeanCurrentlyInCreationFailureAnalyzer	at: org.springframework.boot.diagnostics.analyzer
Class: PatternParseFailureAnalyzer	at: org.springframework.boot.diagnostics.analyzer
Class: BindFailureAnalyzer	at: org.springframework.boot.diagnostics.analyzer
Class: InvalidConfigurationPropertyValueFailureAnalyzer	at: org.springframework.boot.diagnostics.analyzer
Class: BeanNotOfRequiredTypeFailureAnalyzer	at: org.springframework.boot.diagnostics.analyzer
Class: NoSuchMethodFailureAnalyzer	at: org.springframework.boot.diagnostics.analyzer
Class: BindValidationFailureAnalyzer	at: org.springframework.boot.diagnostics.analyzer
Class: PortInUseFailureAnalyzer	at: org.springframework.boot.diagnostics.analyzer
Class: InvalidConfigurationPropertyNameFailureAnalyzer	at: org.springframework.boot.diagnostics.analyzer
Class: ConnectorStartFailureAnalyzer	at: org.springframework.boot.diagnostics.analyzer
Class: AbstractInjectionFailureAnalyzer	at: org.springframework.boot.diagnostics.analyzer
Class: BeanDefinitionOverrideFailureAnalyzer	at: org.springframework.boot.diagnostics.analyzer
Class: ApplicationAvailabilityBean	at: org.springframework.boot.availability
Class: SpringJtaPlatform	at: org.springframework.boot.orm.jpa.hibernate
Class: SpringImplicitNamingStrategy	at: org.springframework.boot.orm.jpa.hibernate
Class: SpringPhysicalNamingStrategy	at: org.springframework.boot.orm.jpa.hibernate
Class: EntityManagerFactoryBuilder	at: org.springframework.boot.orm.jpa
Class: LiquibaseChangelogMissingFailureAnalyzer	at: org.springframework.boot.liquibase
Class: ParentContextCloserApplicationListener	at: org.springframework.boot.builder
Class: ClearCachesApplicationListener	at: org.springframework.boot
Class: ExtendedWhitespaceThrowablePatternConverter	at: org.springframework.boot.logging.log4j2
Class: Log4J2LoggingSystem	at: org.springframework.boot.logging.log4j2
Class: SpringBootConfigurationFactory	at: org.springframework.boot.logging.log4j2
Class: ColorConverter	at: org.springframework.boot.logging.log4j2
Class: SimpleFormatter	at: org.springframework.boot.logging.java
Class: JavaLoggingSystem	at: org.springframework.boot.logging.java
Class: LogbackLoggingSystem	at: org.springframework.boot.logging.logback
Class: LogLevels	at: org.springframework.boot.logging
Class: FilteredMethodValidationPostProcessor	at: org.springframework.boot.validation.beanvalidation
Class: LenientToEnumConverter	at: org.springframework.boot.convert
Class: LenientObjectToEnumConverterFactory	at: org.springframework.boot.convert
Class: DebugAgentEnvironmentPostProcessor	at: org.springframework.boot.reactor
Class: JsonObjectSerializer	at: org.springframework.boot.jackson
Class: JsonComponentModule	at: org.springframework.boot.jackson
Class: JsonObjectDeserializer	at: org.springframework.boot.jackson
Interface: DeterminableImports	at: org.springframework.boot.context.annotation
Interface: Filter	at: org.springframework.boot.util
Interface: RegistrationBeanAdapter	at: org.springframework.boot.web.servlet
Interface: ErrorController	at: org.springframework.boot.web.servlet.error
Interface: ReactiveWebApplicationContext	at: org.springframework.boot.web.reactive.context
Interface: WebClientCustomizer	at: org.springframework.boot.web.reactive.function.client
Interface: ErrorWebExceptionHandler	at: org.springframework.boot.web.reactive.error
Interface: CodecCustomizer	at: org.springframework.boot.web.codec
Interface: SchemaManagementProvider	at: org.springframework.boot.jdbc
Interface: RSocketStrategiesCustomizer	at: org.springframework.boot.rsocket.messaging
